11111111111111111111111111111111111111111
10001000000010001000100000000010001000001
10111010111010101010111110111010101110101
10000010001010100010100000100000100000101
10111111101010111110101011111111101111101
10000010001000100010001010001000101000101
11111010111111101110111110101010111010111
10001010100000000000100000100010000010001
10101110101111111111101111111111111111101
10100000101000000000000010000010000010001
10111111101011111111111011101110111010111
10001000101000100010001000001000100010001
10101011101110111010101111101011101111101
10101000000010001010101000001010001000001
10101111111111101010101111111010111011101
10100010001000101010101000001010100000101
11111010101010101010101011101010101110101
10001000100010000010100010100010101000101
10101111111111111110111110111110111011111
10100000000000001000100010000010001010001
10111110111111101010111010111011101010101
10100000100000100010101010101010001000101
10111111101110111110101010101010111111101
10100000000010001000101000001010000000001
10101111111111101011101111111011111111101
10001000100000101000100000001010001000001
11111110101110101110111111101010101011111
10000000100010001000001000001010101000101
10111010111011111011111011111010101110101
10100010001010000010000010001000100000101
10101111101011111110111110111011111111101
10101000001000000000100000000010000000001
10101111111111111111101111111110111111101
10101000100010000000100000100000100000101
11101010101010111110111110101110111010101
10001010101000100010001000100010001010101
10111010101111101011101011111111101010101
10000010100000001010001000000000001010001
10111110111111111010111111111111111011111
10000010000000000010000000000000000000001
11111111111111111111111111111111111111111